                            
 ## ###          #          
#   #   ##  ###     ##  ### 
# # ##  # # # #  #  # # ##  
# # #   # #  ##  ## # # ### 
 ## ###     ###             